;

#################  
#      #### ##### #
#  ### ###  ##    #
##  &####  ##  # ##
#### ###        ###
##       ###### ###
## ##### ###### ###
## ##### ###### ###
##     # ###    ###
######   ### ## ###
###### # ### ## ###
#      # ###### ###
# ###### ##########
#      ############
 @#################

;

################# 
#####  #### ##### #
#  ### ###  ##    #
##  &####  ##  # ##
#### ###        ###
##       ##########
## ##### ##########
## ##### ##########
##     # ###    ###
######   ### ## ###
###### # ### ## ###
#      #     ## ###
# ###### ### ######
#@     #####    ###
###################

;

#################  
###############    
##              ###
##&    ####     ###
### ## ######## ###
### ## ######## ###
### ## ####     ###
### ## #### #######
### ## #### #######
### ##          ###
### ########### ###
### ########### ###
### ########### ###
#               ###
#@#################

;

################# 
#       &######## #
#        ######## #
# ###### ####     #
# ###### #### #####
# ###### #### #####
# ######      #####
# ######## ########
# ######## ########
#          ########
# #################
# #################
# #################
# #################
#@#################

;

###############    
#       &###### ## 
#        ######    
# ###### ####     #
# ###### #### #####
# ######      #####
#        ##########
# ######## ########
# ######## ########
#          ########
# #################
# #################
# #################
# #################
#@#################

;

################   
#       &#          
#        # ###### #
######## # ##     #
######## # ## #####
########      #####
#        ##########
# ######## ########
# ######## ########
#          ########
# ######## ########
# ######## ########
# ######## ########
#          ########
#@#################

;

#################  
#           #####  
#  ### ###  ##    #
##  &####  ##  # ##
#### ###        ###
##       ###### ###
## ##### ###### ###
## ##### ###### ###
##     #        ###
###### # ### ## ###
###### # ### ## ###
#      # ###### ###
# ###### ##########
#        ##########
 @#################

;

#################  
#           #####  
#  ###&###    #   #
##   ######## #  ##
#### ###        ###
##       ###### ###
## ##### ###### ###
## ##### ###### ###
##     #        ###
###### # ### ## ###
######## ### ## ###
#      # ###### ###
# ###### ##########
#        ##########
 @#################

;

#################  
#       &########  
#        ######## #
# ###### ###      #
# ###### ### #  ###
# ######     # ###
#        #####  ###
# ######## #### ###
# ######## #### ###
#          #### ###
# ############# ###
# ############# ###
# ############# ###
#               ###
#@#################

;

################# 
#       &####      
#        #### ### #
# ###### ###      #
# ######### #   ###
# ######     #  ###
#        #####  ###
# ######## #### ###
# ########      ###
#          #### ###
# ############# ###
# ############# ###
# ############# ###
#               ###
#@#################
